# this file defines acronyms, one acronym per line
ACL - Access Control List
API - Application Program Interface
APR - Automatic Power Reduction
APS - Automatic Protection Switching
APSPORT - Automatic Protection Switching Port
ASIC - Application Specific Integrated Circuit
BGP - Border Gateway Protocol
CPU - Central Processing Unit
CRC - Cyclic Redundancy Code
DCO - Digital Coherent Optical
FCS - Frame Check Sequence
FEC - Forward Error Correction
FPGA - Field Programmable Gate Array
FGA - Fixed Gain Amplifier
HW - Hardware
IP - Internet Protocol
OTAI - Linecard Abstraction Interface
MAC - Medium Access Control
OA - Optical Amplifier
OAM - Operations Administration and Maintenance
OMD - Optical Mux and Demux
OUI - Organizationally Unique Identifier
PAM4 - Pulse Amplitude Modulation 4-level
PN - Packet Number
OTU - Optical Transport Unit
RDI - Remote Defect Indication
RMON - Remote Monitoring
ROADM - Reconfigurable Optical Add-Drop Multiplexer
SDK - Software Development Kit
SDH - Synchronous Digital Hierarchy
SNCP - Subnetwork Connection Protection
SONET - Synchronous Optical Network
SFI - SerDes Framer Interface
SNMP - Simple Network Management Protocol
SNR - Signal to Noise Ratio
SPAN - Switched Port Analyzer
ODU - Optical channel Data Unit
OSC - Optical Supervisory Channel
OTN - Optical Transport Network
PMD - Physical Medium Dependent
TTL - Time to Leave
TTI - Trail Trace Identifier
CPLD - Complex programmable logic device
EEPROM - Electrically erasable programmable read-only memory
PRBS - Pseudorandom Binary Sequence
EDFA - Erbium Doped Fiber Amplifer
VOA - Variable Optical Attenuator
WSS - Wavelength Selective Switch
OCM - Optical Channel Monitor
OTDR - Optical Time Domain Reflectometer
